.ORIG x4000
         .FILL #3 ; N
         .FILL #4 ; M
         .FILL #89 ; the map
         .FILL #88
         .FILL #86
         .FILL #83
         .FILL #79
         .FILL #73
         .FILL #90
         .FILL #80
         .FILL #60
         .FILL #69
         .FILL #73
         .FILL #77
         .END